Go to test folder and edit input.txt with information you want to replace.
Replace field\values.txt with your desired replacement values
Replace information\replacingvalues.txt with your desired replacement values
Click on run.bat
output.txt will be generated in result\output.txt

In my case Infomation is a string 
"uijt jt fyusbpsejobsz up tff dibohf bu podf."

values.txt->replacingvalues.txt

a->1
b->a
c->b
d->c
e->d
f->e
g->f
h->g
i->h
j->i
k->j
l->k
m->l
n->m
o->n
p->o
q->p
r->q
s->r
t->s
u->t
v->u
w->v
x->w
y->x
z->y

if you are linux user change .bat to .sh
